00000000000000000000000000000000000000
00000000000000000000000000000000000000
00000000000000000000000000000000000000
00000000000000000005000000000000000000
00000000000000000001411000000000000000
00000000000000000000400000000000000000
00000000000000000000400000000000000000
20030000000000001101111006000000000002
20111001110111100000001111000000000002
00000000000000000000000000000000000000
00000000000000000000000000000000000000
00000000000000000000000000000000000000
00000000000000000000000000000000000000
